07;04;15;15;03;07;02;14;
13;15;05;05;06;11;06;05;
11;10;06;01;12;06;14;03;
20;21;22;23;24;25;26;27;
30;31;32;33;34;35;36;37;
00;00;00;00;00;00;00;00;